###########################################
#_____________________________#___________#
#_C______S___________2________M___________###
#_____________________________#_____________#
#_____________########________####__________#
#_____________#__C_#M_________#D_#__________#
#_____________#_______________#__#__________#
###___________##############__##_#__________#
  #_________________C#     #__#C____________#
  ####################     ##################










