#################################
#_______________________________#
#_C_____________________________#
#_M___________M_________________#
#_____________########__________#
#_____________#__D_#____________#
#_____________#_____C#__________#
#_____________########__________#
#_S_______________#C____________#
#################################
