###############################
#_____________________________#
#_C___________________________#
#_____________________________#
#_____________########________#
#_____________#__D_#M_________#
#_____________#_______________#
#_____________########________#
#S_______________C#C__________#
###############################
